xxxxxxxxxxxxxxxxxxxxxxxxxxxxxxxxxxxxx
x..b...b...b2..b..b...b..b...b...b..x
x...b....b....b.....b......b..b..b..x
xxxxxxxxxxxxxxxxxxxxxxxxxxxxxxxxxx..x
x..b..b...b.b...b...b..b...b...b..b.x
x.b..b.b..b...b...b..b...b...b..b...x
x..xxxxxxxxxxxxxxxxxxxxxxxxxxxxxxxxxx
xtwb...b..b...b....b..b..b.b..b...b.x
x1...b..b...b...b...b..b.....b..b..bx
xxxxxxxxxxxxxxxxxxxxxxxxxxxxxxxxxx..x
x.t...t...t....t...t...t...t....t..tx
x..t....t....t...t...t...t...t...t..x
xxxxxxxxxxxxxxxxxxxxxxxxxxxxxxxxxxxxx