xxxxxxxxxxxxxxx
x             x
x      ww     x
x    wwwww    x
x   ww   ww   x
x   ww   ww   x
x       ww    x
x      ww     x
x     ww      x
x     ww      x
x             x
x     ww      x
x     ww      x
x             x
xxxxxxxxxxxxxxx
