xxxxxxxxxx
x1..xw..Ix
x..wwxw..x
xwx....xwx
xww.ww.wwx
xww.ww.wwx
xwx....xwx
x..wxww..x
xI..wx..2x
xxxxxxxxxx
