xxx     xxxxxxxxx xxx      
x1x     xw w w wx x2x      
x x     x xxxxx x x x      
x x     xwx   xwx x x      
x x     x x   x x x x      
x x     xwx   xwx x x      
xwxxxxxxx xxxxx xxxwxxxxxxx
x w w w w w w w w w w w w x
xxxxxxxxxxxxxxxxxxxxxxxxxxx