xxxxxxxxxxxxxxxxxxxxxxxxxxxxxxxxxxxxx.
x.................x.................xx
x.I.x...wwwww.x.......x.wwwww...x...xx
xx......wwwww....www....wwwww......xx.
x1....2......x...www...x............xx
x...x...xxx......www.....xxx....x...xx
x.......xxx...x.......x..xxx........x.
x..x.x...........xxx...........x.x..xx
x....x...x..........x.....x....x....xx
x.x..x..x..wwwwww.x.wwwwww..x..x..x.x.
x....x.....wwwwww.x.wwwwww.....x....xx
x....x...x......x.........x....x....xx
x....x...........www...........x....x.
x.......xxx......www.....xxx........xx
xx...x...........www..........x....xxx
x.......xxx...x.......x..xxx........x.
x....x.....xxxxxx.x.xxxxxx.....x....xx
x....x...x......x.........x....x....xx
x....x...........xxx...........x....x.
x...x...xxx..x........x..xxx....x...xx
x.......xxx......xxx.....xxx........xx
xx...x...........xxx..........x....xx.
x.......wwwww....xxx....wwwww.......xx
x...x...wwwww.x.......x.wwwww...x...xx
x.................x.................x 
xxxxxxxxxxxxxxxxxxxxxxxxxxxxxxxxxxxxx.
